0000011200111
0000111000000
0000003000000
0000011110000
1111000000000
