0000010000111
0000111000000
0000000000000
0000011110000
1111000000000
